1111111111111111111111111111111111
1E00000C00000000000000000000000001
1101010100100000101001000000010101
1101010010101010001001000000010101
1P01010000000000000000100000000001
1111111111111111111111111111111111