1111111111111111111111111111111111
1E0000000000000C00000C00M000000001
110M0101C0C0M00010C00100000C010101
11010100M0101010M010010M0000010101
1P0101000C00C10000M000M000000000C1
1111111111111111111111111111111111